Hermann	CQzOqrAS
Littel	GhcVVQQd
Rolfson	FdoDZbaG
Hauck	eqCQSjnJ
Nia	brYTYnzT
Hulda	gNdqtSRj
Waelchi	gFwVpLNZ
Daniel	SsrpCujI
Harvey	MaMIFFmT
Marjorie	WkXITZjH
Hermann	okZBXDwX
Kessler	tmOySYrD
Hilpert	dhrJbjEs
Gerlach	bflpZyMh
Brennan	fmIRFDBh
Ledner	ESXknPLf
Jaskolski	ceiEkkNU
Adams	ApJXTntp
Jenifer	jlGgjbrg
Kshlerin	JQiWgeDT
Haley	PJoMKbOL
Hodkiewicz	mfczktDV
Barton	nRoyhQNv
Kihn	GsMYkShm
Gulgowski	IvuunKbd
Stoltenberg	TGQmsGKD
Funk	qNMdjfos
Renner	JSSWjAud
Prohaska	CvvJWQHn
Abshire	jlaglbyR
