Hermann	FTcRtuDV
Littel	JkfYYTTg
Rolfson	IgrGCedJ
Hauck	htFTVmqM
Nia	euBWBqcW
Hulda	jQgtwVUm
Waelchi	jIzYsOQC
Daniel	VvusFxmL
Harvey	PdPLIIpW
Marjorie	ZnALWCmK
Hermann	rnCEAGzA
Kessler	wpRbVBuG
Hilpert	gkuMemHv
Gerlach	eiosCbPk
Brennan	ipLUIGEk
Ledner	HVAnqSOi
Jaskolski	fhlHnnQX
Adams	DsMAWqws
Jenifer	moJjmeuj
Kshlerin	MTlZjhGW
Haley	SMrPNeRO
Hodkiewicz	pifcnwGY
Barton	qUrbkTQy
Kihn	JvPBnVkp
Gulgowski	LyxxqNeg
Stoltenberg	WJTpvJNG
Funk	tQPgmirv
Renner	MVVZmDxg
Prohaska	FyyMZTKq
Abshire	modjoebU
